7 11
01010000000
01011011110
00000001000
01111111011
00010100000
01110001110
00000100100

